0000000000000000000000000
0000000000000000000000000
0000000000000000000000000
0000000000000000000000000
0000000001222223000000000
0000000007888889000000000
0000000000000000000000000
2222230000000000000000000
8888890000000000000000000
0000000000000000000000000
0000000000000000000000000
2222222222222223000000000
8888888888888889000000000
0000000000000000000001222
0000000000000000000007888
0000000000000000000000000
0000000000000000000000000
2222222222222222222222222
5555555555555555555555555
